#ekspresi dasar python
AND -> and
AS -> as
ASSERT -> assert
ASYNC -> async
AWAIT -> await
BLANK ->  
BREAK -> break
BUKABRACKET -> [
CLASS -> class
COLON -> :
CONTINUE -> continue
DEF -> def
DEL -> del
ELIF -> elif
ELSE -> else
EQUAL -> =
EXCEPT -> except
FALSE -> False
FINALLY -> finally
FOR -> for
FROM -> from
GLOBAL -> global
GREATER -> >
IF -> if
IMPORT -> import
IN -> in
INPUT -> input
IS -> is
KOMA -> ,
KURUNGBUKA -> (
KURUNGTUTUP -> )
LAMBDA -> lambda
LESS -> <
NONE -> None
NONLOCAL -> nonlocal
NOT -> not
OR -> or
PASS -> pass
PRINT -> print
RAISE -> raise
RETURN -> return
TITIK -> .
TRUE -> True
TRY -> try
TUTUPBRACKET -> ]
WHILE -> while
WITH -> with
WORD -> word
YIELD -> yield

OPERATION -> LESS EQUAL | GREATER EQUAL | EQUAL EQUAL | < | > |
ARITH_OPERATION -> ATH_OPR -> * | / | % | + | - 
LOGIC_OPERATION -> or | and














def kotak(k): 
	if 
	for 
	while



	return


FUNGSI -> DEF BLANK NAMA OPENBRACKET CLOSEBRACKET COLON ENTER BLANK CODE | DEF BLANK NAMA OPENBRACKET VARIABLES CLOSEBRACKET COLON ENTER BLANK CODE RETURN VARIABLES | DEF BLANK NAMA OPENBRACKET VARIABLES CLOSEBRACKET COLON ENTER BLANK CODE 

DEF -> def;
BLANK ->  ;
OPENBRACKET -> (;
CLOSEBRACKET -> );
CODE -> SEMUABENTUK; #BINGUNG
ENTER -> 
;












